asdf
asdfasdf
11111111111111asdf
10010000000C11
10C00111110011
1P0011000C0E11
11111111111111
asdfa