asd
11111111
100C0E01
1P000001
11111111
